......X.........................................................X.............
==....X.........................................................X.............
--==..X.........................................................X.............
----..X.........................................................X.............
----=.X............>........>..........................>........X.............
-----==..............................0.............===..........X.............
-------......./.....$..==......==.======........===---==........X.............
-------#@..^=====..===..0..===.............====................#X.............
-------=====-----==---=====---=============----===============================
------------------------------------------------------------------------------
------------------------------------------------------------------------------
------------------------------------------------------------------------------