       X                                                      X             
       X                                                      X             
       X                                                      X             
       X                                                      X             
       X                                                      X             
       X                                                      X             
       X                                                      X             
       X#@     0     ^     ^ 0  /=    +       ^        ^     #X             
============================================================================
----------------------------------------------------------------------------
----------------------------------------------------------------------------
----------------------------------------------------------------------------