.#...............................................
.#...............................................
.#...............................................
.#...............................................
.#...............................................
.#...............................................
.#...............................................
.#.....@.........==...^......?..../......?....#..
=================--==============================
-------------------------------------------------
-------------------------------------------------
-------------------------------------------------