.......X................................................X.............
.......X................................................X.............
.......X................................................X.............
.......X................................................X.............
.......X.....................B..........................X.............
.......X................................................X.............
.......X................................................X.............
.......X.@..............................................X.............
======================================================================
----------------------------------------------------------------------
----------------------------------------------------------------------
----------------------------------------------------------------------