-------...------............-----------------------------------
-------....----...............---------------------------------
-------..@.---...................------------------------------
----------.--.......^-^^-^^^......--------....--->......-------
-------....--.....-----------......0----...>...-...........----
-------....----...-----------.....-----.......................-
-------....--....------........................................
-------^^.......-----..........=======.................#.......
---------...^^-------.0.......=-------../......../...==========
---------===---------===^^^=^^--------===============----------
---------------------------------------------------------------
---------------------------------------------------------------