-------...-------..............---------------------------------------
-------....-----......0...........+-----------------------------------
-------#@..----............^......----------------------------------..
-------===.----......^=^^=^-^......------.....--->........--------....
--------...----....==--------=.....0----...>...-............-----....=
-------.....---==..-----------....-----.............................=-
-------.....--....=-----..........................................==--
-------^^........=----..........======.................#.......===----
-------==^^..^^==-----.$.......=------../....^.../...==========-------
---------======-------===^^^=^^-------===============-----------------
----------------------------------------------------------------------
----------------------------------------------------------------------