........................................
........................................
........................................
........................................
........................................
.......................==...............
................==....=--=..............
.....@........=......=----=.......#.....
==============-======------=============
----------------------------------------
----------------------------------------
----------------------------------------