.#........................................................
.#........................................................
.#........................................................
.#........................................................
.#.......................................?................
.#.......................................=.............#..
.#...............................................=...=====
.#.....@.........==...^......?..../.............=-=..-----
=================--=============================---==-----
----------------------------------------------------------
----------------------------------------------------------
----------------------------------------------------------