.......X..................
.......X..................
.......X..................
.......X..................
.......X..................
...>...X..................
.......X..................
....#..X.@..=..00..^....#.
==========================
--------------------------
--------------------------
--------------------------