-------...-------..............---------------------------------------
-------....-----..................------------------------------------
-------.@..----............^......----------------------------------..
-------===.----......^=^^=^-^......------.....--->........--------....
--------...----....==--------=.....0----...>...-............-----....=
-------.....---==..-----------....-----.............................=-
-------.....--....=-----..........................................==--
-------^^........=----..........======.................#.......===----
-------==^^..^^==-----.0.......=------../....^.../...==========-------
---------======-------===^^^=^^-------===============-----------------
----------------------------------------------------------------------
----------------------------------------------------------------------