.......#....................................................................
.......#....................................................................
.......#....................................................................
.......#....................................................................
.......#.......................................?............................
.......#.......................................=.............#..............
.......#...............................................=...=================
.......#.....@.........==...^......?..../.............=-=..-----------------
=======================--=============================---==-----------------
----------------------------------------------------------------------------
----------------------------------------------------------------------------
----------------------------------------------------------------------------