......X.........................................................X.............
==....X.........................................................X.............
--==..X.........................................................X.............
----..X.........................................................X.............
----=.X............>.......->..........................>........X.............
-----==............................................===..........X.............
-------.......^........==......==.======........===---==........X.............
-------#@..v=====..===.....===.............====................#X.............
-------=====-----==---=====---=============----===============================
------------------------------------------------------------------------------
------------------------------------------------------------------------------
------------------------------------------------------------------------------