      X                 ----------------------------------------=           X
      X                =-----------------          --------------=          X
      X              ==--                     ==           -------==        X
      X            ==--                    =  --           ---------        X
      X#     @                  ^^  ^^       =--^^  /  ^^  ---------==      X
===========================^^^===============---=========  -----------=     X
------------------------------------------       //        ------------     X
------------------------------------------  ===============------------=    X
------------------------------------------  /          /      #XXXXXXXXXXXXXX
------------------------------------------===================================
-----------------------------------------------------------------------------
-----------------------------------------------------------------------------